8
6
XXXXXX
X0000X
X0001X
X0000X
X0100X
X0000X
X0000X
XXXXXX
