15
31
ZZZZZZZZZZZZZZZZZZZZZZZZZZZZZZZ
Z00000000000000000000000000000Z
Z00010000000000000000000000000Z
Z00000000000000000010000000000Z
Z01000000000000010001000000000Z
Z00000000000000010001000000000Z
Z00000000000000010001000000000Z
Z00000000000000011111000000000Z
Z00000000000000000000000000000Z
Z00000000000000000000000000000Z
Z00000000000000000000000000000Z
Z00000000000000000000000000000Z
Z00000000000000000000000000000Z
Z00000000000000000000000000000Z
ZZZZZZZZZZZZZZZZZZZZZZZZZZZZZZZ