15
60
ZZZZZZZZZZZZZZZZZZZZZZZZZZZZZZZZZZZZZZZZZZZZZZZZZZZZZZZZZZZZ
Z0000000000000000000000000000000000000000000000000000000000Z
Z0001000000000000000000000000000000000000000000000000000000Z
Z0000000000000000000000000000000000000000000000000000000000Z
Z0100000000000001000100000000000000000000000000000000000000Z
Z0000000000000001000100000000000000000000000000000000000000Z
Z0000000000000001000100000000000000000000000000000000000000Z
Z0000000000000001111100000000000000000000000000000000000000Z
Z0000000000000000000000000000000000000000000000000000000000Z
Z0000000000000000000000000000000000000000000000000000000000Z
Z0000000000000000000000000000000000000000000000000000000000Z
Z0000000000000000000000000000000000000000000000000000000000Z
Z0000000000000000000000000000000000000000000000000000000000Z
Z0000000000000000000000000000000000000000000000000000000000Z
ZZZZZZZZZZZZZZZZZZZZZZZZZZZZZZZZZZZZZZZZZZZZZZZZZZZZZZZZZZZZ
